111111111111111111
11100000000E000001
10000000001C111111
1000C0000000000001
10000011P110000001
11C0000000000000C1
111111111111111111